#############################
#  #                        #
#  #                        #
#  #              #         #
#  #######        #         #
#        #        #         #
# @      #        #         #
#        #        #         #
#        ##########         #
#                           #
#                           #
#                           #
#############################